111111111111111
100000C000000P1
100000000E00001
111111111111111
