111111111111111
1P00001C0000001
100000000000001
10C000111111101
1000000CE000001
111111111111111
