111111111111111
1P00000C0000001
1E0000000000001
111111111111111
