111111111111111
1000000E00000P1
100000000000011
100000000000001
100C00000000001
100000000000001
10000C000000C01
111111111111111
